Mm, Mm, Mm, Mm, Mm, Mm, Mm, Mm, Mm, Mm, Mm, Uu, Mm, Mm, Mm, Mm, Mm, Mm, Mm, Mm, Mm, Mm, Mm
Mm, Mm, Mm, Mm, Mm, Mm, Mm, Mm, Mm, Mm, Mm, Uu, Mm, Mm, Mm, Mm, Mm, Mm, Mm, Mm, Mm, Mm, Mm
Mm, Gs, Gs, Gs, Gs, Gs, Gs, Gs, Gs, Gs, Ur, Ur, Ur, Gs, Gs, Gs, Gs, Gs, Gs, Gs, Gs, Gs, Mm
Mm, Gs, Gs, Gs, Gs, Gs, Gs, Gs, Ce, Ce, Ce, 1 Ket, 2 Ce, Ce, Ce, Gs, Gs, Gs, Gs, Gs, Gs, Gs, Mm
Mm, Gs, Gs, Gs, Gs, Gs, Gs, Gs, Gs, Gs, Gs, Gs, Gs, Gs, Gs, Gs, Gs, Gs, Gs, Gs, Gs, Gs, Mm
Mm, Gs, Gs, Gs, Gs, Gs, Gs, Gs, Gs, Gs, Gs, Gs, Gs, Gs, Gs, Gs, Gs, Gs, Gs, Gs, Gs, Gs, Mm
Mm, Gs, Ss, Ss, Ss, Gs, Gs, Gs, Gs, Gs, Gs, Gs, Gs, Gs, Gs, Gs, Gs, Gs, Gs^Tf, Gs^Tf, Gs^Tf, Gs, Mm
Mm, Gs, Ss, Ss, Ss, Rr^Vd, Gs, Gs, Gs^Ft, Gs, Gs^Ft, Gs, Gs^Ft, Gs, Gs^Ft, Gs, Gs, Rr^Vd, Gs^Tf, Gs^Tf, Gs^Tf, Gs, Mm
Mm, Gs, Gs, Ss, Gs, Gs, Gs, Gs^Ft, Gs, Gs^Ft, Gs, Gs, Gs, Gs^Ft, Gs, Gs^Ft, Gs, Gs, Gs, Gs^Tf, Gs, Gs, Mm
Mm, Gs, Gs, Gs, Gs, Gs, Gs, Dd, Gs, Gs, Gs, Gs, Gs, Gs, Gs, Dd, Gs, Gs, Gs, Gs, Gs, Gs, Mm
Mm, Gs, Wot, Gs, Gs, Gs, Gs, Dd, Gs, Gs, Gs, Rr^Vd, Gs, Gs, Gs, Dd, Gs, Gs, Gs, Hh, Gs, Gs, Mm
Mm, Gs, Wot, Wot, Gs, Gs, Gs, Dd, Gs, Gs, Gs, Gs, Gs, Gs, Gs, Dd, Gs, Gs, Gs, Hh, Gs, Gs, Mm
Mm, Gs, Gs, Gs, Gs, Rr^Vd, Gs, Dd, Dd, Gs, Gs, Gs, Gs, Gs, Dd, Dd, Gs, Rr^Vd, Gs, Gs, Gs, Gs, Mm
Mm, Gs, Uu, Gs, Uu, Gs, Gs, Gs, Gs, Dd, Hh, Hh, Hh, Dd, Gs^Ft, Gs, Gs, Gs, Gs, Gs, Gs, Gs, Mm
Mm, Uu, Uu, Uu, Uu, Uu, Xu, Gs, Gs, Gs, Gs, Hh, Gs, Gs, Gs, Gs, Wwt, Wwt, Wwt, Wwt, Wwt, Wwt, Mm
Mm, Uu, Gs, Uu, Gs, Uu, Gs, Xu, Xu, Gs, Rd, Rd, Rd, Gs, Wwt, Wwt, Gs, Gs, Gs, Gs, Gs, Gs, Mm
Mm, Gs, Gs, Gs, Gs, Gs, Hh, Gs, Gs, Xu, Qlf, Qlf, Qlf, Rd, Gs, Gs, Gs, Gs^Tf, Gs, Gs, Gs, Gs, Mm
Mm, Gs, Gs, Rr^Vd, Gs, Gs, Gs, Gs, Gs, Xu, Qlf, Qlf, Qlf, Xu, Gs, Gs, Hh, Gs, Gs, Rr^Vd, Gs, Gs, Mm
Mm, Gs, Gs, Gs, Gs, Gs^Tf, Gs, Gs, Wwt, Rd, Rd, Qlf, Rd, Xu, Xu, Gs, Gs, Gs, Gs, Gs, Gs, Gs, Mm
Mm, Gs, Wwt, Gs, Wwt, Gs, Wwt, Wwt, Gs, Gs, Gs, Rd, Gs, Gs, Gs, Xu, Xu, Uu, Uu, Uu, Uu, Uu, Mm
Mm, Wwt, Gs, Wwt, Gs, Wwt, Gs, Gs, Gs^Ft, Gs, Hh, Hh, Hh, Gs, Gs, Gs, Gs, Uu, Uu, Uu, Uu, Uu, Mm
Mm, Gs, Gs, Gs, Gs, Gs, Gs, Gs, Dd, Dd, Gs, Hh, Gs, Dd, Dd, Gs, Gs, Gs, Gs, Gs, Gs, Gs, Mm
Mm, Gs, Gs, Gs, Gs, Rr^Vd, Gs, Dd, Gs, Gs, Gs, Gs, Gs, Gs, Gs, Dd, Gs, Rr^Vd, Gs, Gs, Wot, Gs, Mm
Mm, Gs, Gs, Hh, Gs, Gs, Gs, Dd, Gs, Gs, Gs, Gs, Gs, Gs, Gs, Dd, Gs, Gs, Gs, Wot, Wot, Gs, Mm
Mm, Gs, Gs, Hh, Gs, Gs, Gs, Dd, Gs, Gs, Gs, Rr^Vd, Gs, Gs, Gs, Dd, Gs, Gs, Gs, Gs, Gs, Gs, Mm
Mm, Gs, Gs, Gs, Gs, Gs, Gs, Dd, Gs, Gs, Gs, Gs, Gs, Gs, Gs, Dd, Gs, Gs, Gs, Gs, Gs, Gs, Mm
Mm, Gs, Gs^Tf, Gs^Tf, Gs^Tf, Gs, Gs, Gs^Ft, Gs^Ft, Gs^Ft, Gs^Ft, Gs, Gs^Ft, Gs^Ft, Gs^Ft, Gs^Ft, Gs, Gs, Ss, Ss, Ss, Gs, Mm
Mm, Gs, Gs^Tf, Gs^Tf, Gs^Tf, Rr^Vd, Gs, Gs, Gs, Gs, Gs, Gs, Gs, Gs, Gs, Gs, Gs, Rr^Vd, Ss, Ss, Ss, Gs, Mm
Mm, Gs, Gs, Gs^Tf, Gs, Gs, Gs, Gs, Gs, Gs, Gs, Gs, Gs, Gs, Gs, Gs, Gs, Gs, Gs, Ss, Gs, Gs, Mm
Mm, Gs, Gs, Gs, Gs, Gs, Gs, Gs, Gs, Gs, Gs, Gs, Gs, Gs, Gs, Gs, Gs, Gs, Gs, Gs, Gs, Gs, Mm
Mm, Gs, Gs, Gs, Gs, Gs, Gs, Gs, Ce, Gs, Ce, Gs, Ce, Gs, Ce, Gs, Gs, Gs, Gs, Gs, Gs, Gs, Mm
Mm, Gs, Gs, Gs, Gs, Gs, Gs, Gs, Gs, Ce, Ur, 3 Ket, Ur, Ce, Gs, Gs, Gs, Gs, Gs, Gs, Gs, Gs, Mm
Mm, Gs, Mm, Gs, Mm, Gs, Mm, Gs, Mm, Gs, Mm, Ur, Mm, Gs, Mm, Gs, Mm, Gs, Mm, Gs, Mm, Gs, Mm
Mm, Mm, Mm, Mm, Mm, Mm, Mm, Mm, Mm, Mm, Mm, Uu, Mm, Mm, Mm, Mm, Mm, Mm, Mm, Mm, Mm, Mm, Mm
Mm, Mm, Mm, Mm, Mm, Mm, Mm, Mm, Mm, Mm, Mm, Uu, Mm, Mm, Mm, Mm, Mm, Mm, Mm, Mm, Mm, Mm, Mm
