Ww, Ww, Ww, Ww, Ww, Gs, Gs^Fmf, Gs^Fp, Gs^Fmf, Gs^Fmf, Ss, Ss, Gs^Fmf, Gg, Gg, Gg, Gg, Re, Gg, Gg, Ss, Gg, Re, Gg, Gg, Ss, Ss
Ww, Ww, Ww, Ww, Ww, Gs, Gs^Fmf, Gs^Fmf, Gs^Fmf, Gs^Fp, Ss, Ss, Gs^Fmf, Gg, Gg, Gg, Gs, Re, Gg, Gg, Ss, Gg, Re, Gg, Gs^Vh, Ss, Ss
Ww, Ww, Ww, Ww, Ds, Ds, Gs, Gs^Fp, Gs^Fmf, Ss, Ss, Gs^Fmf, Gs^Fmf, Gg, Gg, Gg, Re, Re, Gs^Vh, Ss, Ss, Gg, Gs, Gs, Gg, Ss, Ss
Wo, Wo, Ww, Ww, Ds, Ds, Gs, Gs, Gg, Gg, Ss, Gg, Gg, Gg, Gg, Re, Gs, Gg, Gg, Ss, Ss, Ss, Gg, Re, Re, Gg, Gg
Wo, Wo, Ww, Ww, Ww, Ds, Gs, Gs, Ss, Ss, Gg, Ss, Ss, Gg, Ww, Re, Ww, Ww, Ww, Ss, Gg, Gg, Gg, Gs, Gs, Gg, Gg
Wo, Wo, Wo, Ww, Ww, Gs, Gs, Gg, Ss, Ss, Gg, Gg, Ww, Ww, Ww, Ww^Bw|, Ww, Wo, Wo, Ww, Gg, Gg, Re, Re, Gg, Gg, Gg
Wo, Wo, Wo, Ww, Ww, Gs, Gs, Gg, Gg, Ss, Ww, Ww, Wo, Wo, Ww, Ww^Bw|, Gg, Ww, Ww, Ww, Ww^Bw/, Re, Gg, Gg, Gg, Gs^Fmf, Gs^Fmf
Wo, Wo, Wo, Ww, Ww, Ww, Gs, Gg, Gg, Ww, Wo, Wo, Ww, Ww, Ce, Re, Ce, Ww, Ww^Bw/, Ww^Bw/, Ww, Ww, Ww, Ss, Gg, Gs^Fmf, Gs^Fp
Wo, Wo, Wo, Ww, Ww, Ww, Gs, Gs^Vh, Ww, Ww, Ww, Ww, Ds, Gg, Gs, Re, Re, Re, Gg, Ww, Ww, Wo, Wo, Ww, Ww, Ww, Ww
Wo, Wo, Wo, Ww, Ww, Ww, Ww, Ww, Wo, Wo, Ww, Ww^Bw\, Ds, Gg, Re^Vh, Re, Gs^Fdf, Gg, Gg, Gg, Gg, Ww, Ww, Wo, Wo, Ww, Ww
Wo, Wo, Wo, Wo, Wo, Ww, Ww, Ww, Ww, Ww, Ww, Ds, Re, Re, Re, Re, Gs, Gs^Fdf, Gg, Gg, Gg, Gg^Fdf, Gg^Fdf, Ww, Ww, Wo, Wo
Wo, Wo, Wo, Wo, Ww, Ww, Ww^Bw\, Ww, Gg, Ww, Ww, Ds, Gg, Gg, Gs, Re, Re, Gg, Gs, Gs, Gg, Gg, Ds, Ww, Ww, Wo, Wo
Wo, Wo, Wo, Wo, Ww, Ww, Ds, Ds, Gg, Gg, Ww, Ww, Ce, Gg, Re, Re, Ce, Re, Re, Gg, Gg, Gg, Ds, Ww, Wo, Wo, Wo
Wo, Wo, Wo, Ww, Ww, Ww, Ds, Re, Re, Re^Vh, Gg, Ww, Re, Re, Re, Ce, 3 Ket, Ce, Re, Gs, Gg, Ds, Ww, Ww, Ww, Ww, Ww
Wo, Wo, Wo, Ww, Ww, Ww, Ds, Gg, Re, Re, Re, Ww^Bw/, Ce, Gs, Re, Ce, Ce, Ce, Re, Gs^Vh, Gg, Ds, Ww, Wo, Ww, Ww, Ww
Wo, Wo, Wo, Ww, Ww, Ww, Ds, Re, Gg, Re, Gg, Ww, Gg, Gg, Gs^Vh, Re, Re, Re, Gs^Fdf, Gg, Gg, Ww, Wo, Ww, Gg, Gg, Gg
Wo, Wo, Wo, Ww, Ww, Ww^Bw/, Ww, Ds, Ds, Gg, Ww, Ww, Gg^Fdf, Gg^Fdf, Gg, Gs, Gg, Re, Re, Gs, Re, Ww, Ww, Ww, Gg, Gg, Gg
Wo, Wo, Wo, Wo, Ww, Ww, Ww, Ww, Ww, Gg, Ww, Ww, Ww, Gg^Fdf, Gg, Gg, Re, Re, Re^Vh, Re, Gg, Ww^Bw\, Ww^Bw\, Gg, Gg, Gg^Vh, Gg
Wo, Wo, Wo, Wo, Wo, Ww, Ww, Ww, Ww, Ww, Ww, Wo, Ww^Bw/, Ds, Re, Re, Gg, Re, Gg, Gg, Ds, Ww, Ww, Re, Re, Gg, Gg
Wo, Wo, Wo, Wo, Ww, Ww, Gs, Ww, Ww, Ww, Wo, Ww, Ww, Ds, Ds, Gg, Ce, Re, Ce, Ds, Ww, Ww, Ww, Gg, Re, Gg, Gg
Wo, Wo, Wo, Ww, Ww, Ww, Gs, Gs, Gg, Ww, Wo, Ww, Ww, Ww, Ww, Gg, Ww, Ww^Bw|, Ww, Ww, Ww, Ww, Gg, Gg, Re, Gg, Gg
Wo, Wo, Ww, Ww, Gs, Gs, Gs^Fdf, Gg, Gg, Ww, Ww, Ww, Ww, Ww, Ww, Ww, Ww, Ww^Bw|, Ww, Ww, Gg, Gg, Gg, Gg, Re, Gg, Gg
Wo, Wo, Ww, Ww, Gs, Gs^Fmf, Gs^Fmf, Gg, Gg, Gg, Gg^Efm, Gg, Gg, Ww, Gg, Ww, Gg, Re, Gg, Gg, Gg, Gg, Gg, Gg, Re, Gg, Gg
Wo, Wo, Ww, Ww, Gs, Gs^Fdf, Gs^Fdf, Gg, Gg, Gg, Gg, Gg^Efm, Gg, Gg, Gg, Gg, Gg, Re, Gg, Gg, Gg, Gg, Gg, Re, Gg, Gg, Gg
Wo, Wo, Wo, Ww, Gs, Gs, Gs, Gg, Gg, Gg, Gg, Gg, Gg^Efm, Gg, Gg^Efm, Gg, Gg, Re, Re, Gg, Gg, Gg, Gg, Re, Gg, Gs^Fmf, Gs^Fmf
Wo, Wo, Wo, Ww, Ww, Gs, Gs, Gs, Gs^Fdf, Gs^Fdf, Gs^Fmf, Gg, Gg, Gg, Gg^Vh, Gg, Gs^Fdf, Gs^Fdf, Re, Gg, Gg, Gg, Gg, Re, Gs^Fdf, Gs^Fdf, Gs^Fdf
Wo, Wo, Ww, Ww, Ww^Bw\, Ds, Gs, Gs^Fdf, Gs^Fdf, Gs^Fdf, Gs^Fmf, Gg, Gs^Fdf, Gg, Gg, Gg, Gg, Gs^Fdf, Re, Gs^Fdf, Gs^Fdf, Gg^Vh, Gg, Re, Gg, Gs^Fdf, Gs^Fmf
Wo, Wo, Ww, Ww, Ds, Ds, Gs, Gs^Vh, Gs^Fmf, Gs^Fmf, Gs^Fdf, Gs^Fmf, Gs^Fmf, Gg, Gg^Efm, Gg, Gg, Gg, Re, Gs^Fdf, Gs^Fdf, Gs^Fdf, Gg, Re, Gg, Gg, Re^Gvs
Wo, Wo, Ww, Ww, Ds, Re, Re, Gs^Fdf, Gs, Gs^Fmf, Gg, Gg, Re, Re, Re, Re, Re, Re, Gg, Re, Re, Re, Re, Re, Gg, Re^Gvs, Re^Gvs
Wo, Wo, Ww, Ww, Gs, Gs, Gs, Gs^Fdf, Gs^Fdf, Gs^Fmf, Gs^Fdf, Gs^Fdf, Gs^Fdf, Gs^Fdf, Gg, Gg, Gg, Gg^Efm, Re^Gvs, Gg, Re, Gs^Fmf, Gs^Fmf, Gs^Fdf, Gs^Fmf, Gg, Gg
Wo, Wo, Ww, Ds, Ds, Gs, Gs, Gs, Re^Gvs, Gg, Gg, Gg, Gg^Efm, Gg, Gg, Gg, Re^Gvs, Re^Gvs, Re^Gvs, Gg, Re, Gg, Gg, Gg, Gs^Fmf, Gs^Fdf, Gs^Fmf
Wo, Wo, Ww, Ww, Ds, Gs, Re^Gvs, Re^Gvs, Re^Gvs, Gg^Efm, Gg, Gg^Efm, Gg, Hh, Mm, Mm, Mm, Re^Gvs, Gs, Gg^Efm, Re, Gg, Gg, Gg, Gs^Fdf, Gs^Fmf, Gs^Fmf
Wo, Wo, Wo, Ww, Ds, Gs, Re^Gvs, Re^Gvs, Gs, Mm, Hh, Gg, Gg, Hh, Hh, Mm, Hh, Mm, Gs^Vh, Gg, Re, Gg, Gg, Gg, Gs^Fdf, Gs^Fdf, Gs^Fdf
Wo, Wo, Wo, Ww, Ww, Gs, Gs, Gs, Mm, Mm, Hh, Gs, Hh, Gs, Hh, Hh, Mm, Mm, Mm, Gg, Gg, Re, Gg, Gg, Gs^Fdw, Gs^Fdf, Gs^Fdf
Wo, Wo, Wo, Wo, Ww, Gs, Gs, Gg^Efm, Mm, Mm, Mm, Hh, Mm, Hh, Mm, Mm, Gs, Mm, Gg, Gg, Gg^Efm, Re, Re, Gs^Vh, Gs^Fdf, Gs^Fdf, Gs^Fdf
Wo, Wo, Ww^Vm, Ww, Ds, Gs, Gs, Gg, Mm, Gs^Vh, Gs, Gs, Mm, Mm, Gs, Mm, Mm, Gg, Re^Gvs, Gg, Gg, Gg, Re, Gg, Gg, Gs^Fdf, Gs^Fdf
Wo, Wo, Wo, Ww, Ds, Gs, Gs, Gg, Gg, Mm, Mm, Mm, Gs, Mm, Gs, Gg, Re^Gvs, Re^Gvs, Re^Gvs, Re^Gvs, Re^Gvs, Gg, Re, Gg, Gg, Gg, Gg
Wo, Wo, Wo, Ww, Ww, Ds, Gs, Gs, Gg, Mm, Gg, Mm, Gg, Gg^Efm, Gg, Gg, Gg^Efm, Re^Gvs, Re^Gvs, Re^Gvs, Gg, Gg, Re, Gg, Hh, Gg, Gg
Wo, Wo, Wo, Wo, Ww, Ds, Gs, Gg^Efm, Gg, Gg^Efm, Gg, Gg, Gs^Fdf, Gg, Gg, Gg, Gs, Gg, Re, Gg, Gs, Re, Gs, Gs^Vh, Hh, Hh, Hh
Wo, Wo, Wo, Wo, Ww, Ds, Gs, Gs, Gs^Fdf, Gs^Fdf, Gs^Fdf, Gg, Gg, Gg, Gg, Gg, Gs, Gs, 2 Ce, Ce, Ce, Re, Re, Gs^Fdf, Gs, Hh, Hh
Ww, Ww, Ww, Ww, Ds, Ds, Gs, Gs, Gg, Gs^Fdf, Gg^Vh, Gs^Fdf, Gg, Gg, Gg, Gg, Re, Re, Ce, 1 Ke, Ce, Re, Re, Re, Re, Re, Re
Ww, Ww, Ww, Ds, Gs, Gs, Gs, Gg, Gg, Gs^Fdf, Gs^Fdf, Gs^Fdf, Gg, Gg, Gg, Gg, Gg, Re, Gs, Ce, Gs, Hh, Gg, Gg, Hh, Hh, Hh
Ww, Ww, Ww, Ds, Gs, Gs, Gg, Gg, Gg, Gs^Fdf, Gs^Fdf, Gs^Fdf, Gg, Gg, Gg, Gg, Gg, Re, Gg, Gg, Gg, Hh, Gg, Gg, Hh, Hh, Hh
