Gg, Gs^Fms, Gs^Fms, Gs^Fms, Gs^Fms, Gg, Gs^Fms, Gg, Gs^Fms, Gg, Gs^Fms, Gs^Fms, Gs^Fms, Gs^Fms, Gs^Fms, Gs^Fms, Gs^Fms, Gs^Fms, Gs^Fms, Gs^Fms, Gs^Fms, Gs^Fms, Gs^Fms, Gs^Fms, Gs^Fms, Gs^Fms, Gs^Fms, Gs^Fms, Gs^Fms, Gs^Fms, Gs^Fms, Gs^Fms, Gs^Fms, Gs^Fms, Gs^Fms, Gs^Fms, Gs^Fms, Gs^Fms, Gs^Fms, Gs^Fms, Gs^Fms, Gs^Fms, Gs^Fms, Gs^Fms, Gs^Fms, Gg
Gs^Fms, Gs^Fms, Gg, Gs^Fms, Ce, Gs^Fms, Gg, Gs^Fms, Gg, Gs^Fms, Gg, Gs^Fms, Gg, Gg, Gs^Ve, Gg, Gg, Gg, Gg, Gg, Gg, Gg, Gs^Fms, Gs^Fms, Gs^Fms, Gs^Fms, Gs^Fms, Gs^Fms, Gs^Fms, Gs^Fms, Gs^Fms, Gs^Fms, Gg, Gg, Gs^Fms, Gg, Gs^Fms, Gg, Gg, Gg, Gg, Gs^Fms, Gg, Gg, Gg, Gg
Gg, Gs^Fms, Gg, Ce, 1 Ke, 2 Ce, Gg, Gg, Gg, Gg, Gg, Gg, Gg, Gs^Fds, Gs^Fds, Gs^Fds, Gs^Fds, Gg, Gs^Fms, Gg, Gs^Fms, Gs^Fms, Gs^Fms, Gs^Fms, Gs^Fms, Gs^Fms, Gs^Fms, Gs^Fms, Gs^Fms, Gs^Fms, Gs^Fms, Gs^Fms, Gll^Tf, Gs^Fms, Gs^Fms, Gs^Fms, Gs^Fms, Gs^Fds, Gs^Fds, Gs^Fds, Gs^Fds, Gg, Gg, Gg, Gs^Fms, Gg
Gs^Fms, Gs^Fms, Gg, Ce, Ce, Ce, Gg, Gg, Gg, Gg, Gs^Fms, Gs^Fms, Gs^Fds, Gs^Fds, Gs^Fds, Gs^Fds, Gs^Fms, Gs^Fms, Gs^Fms, Gs^Fms, Gs^Fms, Gs^Fet, Gs^Fms, Gs^Ve, Gs^Fms, Gs^Fms, Gs^Fms, Gs^Fms, Gs^Fms, Gs^Fet, Gs^Fms, Gs^Fms, Gs^Fms, Gs^Fms, Gs^Fms, Gs^Fms, Hh^Fms, Hh^Fet, Hh^Fms, Gs^Fds, Gs^Fms, Gs^Fds, Gs^Fms, Gs^Fms, Gs^Fms, Gs^Fms
Gs^Fms, Gs^Fms, Gg, Gg, Gg, Gg, Gs^Fms, Gs^Fms, Gs^Fms, Gs^Fms, Gs^Fms, Gs^Fms, Gs^Fds, Gs^Fds, Gs^Fds, Gs^Fds, Gs^Fms, Gll^Tf, Gs^Fms, Gs^Fms, Gs^Fms, Gs^Fms, Gs^Fms, Gs^Fms, Gs^Fms, Gs^Fms, Gg, Gg, Gg, Gg, Gg, Gs^Fds, Gs^Fds, Gs^Fms, Hh^Fms, Hh^Fms, Hh^Fms, Hh^Fms, Hh^Fms, Hh^Fms, Gs^Fms, Gs^Fms, Gs^Fms, Gs^Fms, Gs^Fms, Gs^Fms
Gs^Fms, Gs^Fms, Gg, Gg, Gs^Fms, Gs^Fms, Gs^Fms, Gs^Fms, Gs^Fms, Gs^Fms, Gs^Fds, Gs^Fds, Gs^Fds, Gs^Fds, Gs^Fms, Gs^Fms, Gs^Fms, Gs^Fms, Gs^Fms, Gs^Fms, Hh^Fds, Hh^Fms, Hh, Hh, Hh, Gg, Gs^Fms, Gs^Fms, Gs^Fms, Gg, Gg, Gs^Fds, Gs^Ve, Gs^Fds, Hh^Fds, Hh^Fms, Hh^Fp, Hh^Fp, Hh^Fp, Hh^Fp, Gll^Fp, Gll^Fp, Gll^Fp, Gll^Fp, Gs^Fms, Gs^Fms
Gg, Gs^Fms, Gs^Fms, Gs^Fms, Gs^Fms, Gs^Fms, Gg, Gs^Fms, Gs^Ve, Gs^Fds, Gs^Fds, Gs^Fds, Gg, Gs^Fds, Gs^Fms, Gs^Fms, Gs^Ve, Gs^Fms, Gs^Fds, Hh^Fds, Hh, Hh, Hh, Gg, Gs^Fms, Hh, Hh^Fms, Gs^Fms, Gs^Fms, Gs^Fms, Gs^Fms, Gs^Fds, Gs^Fds, Gs^Fds, Hh^Fp, Hh^Fp, Hh^Fds, Hh^Fds, Hh^Fds, Gs^Fms, Gs^Fds, Gs^Fms, Gs^Fds, Gs^Fms, Gg, Gg
Gg, Gs^Fms, Gs^Fms, Gg, Gs^Fms, Gs^Fms, Gs^Fms, Gs^Fds, Gs^Fds, Gs^Fds, Gs^Fds, Gg, Gg, Gg, Gs^Fms, Gs^Fms, Gs^Fms, Gs^Fds, Gs^Fds, Hh^Fds, Hh^Fds, Hh^Fds, Hh^Fds, Hh^Fms, Hh^Fds, Hh^Fms, Gs^Fms, Gs^Fms, Gs^Fms, Gs^Fms, Gs^Fms, Gs^Fds, Gll^Fp, Hh^Fp, Hh^Fp, Hh^Fp, Hh^Fds, Gs^Fds, Gs^Fds, Gs^Fds, Gs^Fms, Gs^Fds, Gg, Gg, Gg, Gg
Gs^Fms, Gs^Fms, Gs^Fms, Gs^Fms, Gs^Fms, Gs^Fms, Gs^Fms, Gs^Fms, Gs^Fds, Gs^Fds, Gg, Gg, Gg, Gs^Fms, Gs^Fms, Gs^Fms, Gs^Fms, Gs^Fds, Gs^Fds, Gs^Fds, Gs^Fds, Gs^Fds, Gs^Fds, Gs^Fds, Gs^Fds, Gs^Fds, Gs^Fds, Gs^Fms, Gs^Fds, Gll^Tf, Gll^Fp, Gll^Fp, Gs^Fms, Gll^Fp, Gll^Fp, Gs^Fds, Gg, Hh, Hh, Gs^Fms, Gg^Ve, Gs^Fms, Gs^Fms, Gg, Gg, Gg
Gs^Fms, Gs^Fms, Gs^Fms, Gll^Tf, Gs^Fms, Gs^Fms, Gg, Gg, Gs^Fds, Gs^Fds, Gs^Fds, Gs^Fds, Gs^Fms, Gs^Fms, Gs^Fms, Gs^Fms, Gll^Tf, Ss, Ss, Gs^Fds, Gs^Fds, Gs^Fds, Gs^Fds, Gs^Ve, Gs^Fds, Gs^Fds, Gs^Fds, Gs^Fms, Gs^Fds, Gll^Fp, Gll^Fp, Gll^Fp, Gll^Fp, Gll^Fp, Gs^Fms, Gs^Fms, Gs^Fms, Gg, Gg, Hh^Fms, Hh^Fds, Gs^Fms, Gs^Fms, Gg, Gg, Gg
Gg, Gs^Fms, Gs^Fds, Gs^Fds, Gs^Ve, Gs^Fms, Hh^Fds, Hh^Fds, Hh^Fds, Hh^Fds, Hh^Fms, Gs^Fms, Gs^Fms, Gs^Fms, Gs^Fms, Gs^Fms, Gs^Fms, Ss, Ss, Gs^Fds, Gs^Fds, Gs^Fms, Gs^Fds, Gs^Fds, Gs^Fds, Gs^Fds, Gll^Fp, Gs^Fms, Gll^Fp, Gll^Fp, Gs^Fds, Gg, Gg, Gs^Fms, Gs^Fms, Gs^Fms, Gs^Fms, Gs^Fms, Gs^Fms, Gs^Fds, Gs^Fds, Gs^Fds, Gs^Fds, Gg, Gg, Gg
Gg, Gs^Fds, Gs^Fds, Gs^Fds, Gs^Fds, Gs^Fds, Hh^Fds, Hh^Fds, Hh^Fms, Hh^Fms, Hh^Fms, Hh^Fms, Gs^Fms, Gs^Fms, Gs^Fds, Gs^Fds, Gs^Fds, Gs^Fds, Ss, Ss, Gs^Fds, Gs^Fds, Gs^Fds, Gll^Fp, Gll^Fp, Gll^Fp, Gg, Gll^Fp, Gs^Fms, Gs^Fds, Gs^Fms, Gg, Gs^Fms, Gs^Fms, Gs^Fms, Gs^Fms, Ds, Gs^Fms, Ds, Gs^Fds, Gs^Fds, Gs^Fds, Gs^Fds, Gg, Ww, Gg
Gg, Gg, Gg, Gs^Fds, Gg, Hh^Fds, Hh^Fds, Hh^Fms, Hh^Fp, Hh^Fp, Hh^Fp, Hh^Fms, Gs^Fds, Gs^Fds, Gs^Fds, Gs^Fds, Gs^Fds, Gs^Fds, Gs^Fds, Ss, Ss, Gs^Fds, Gs^Fds, Gs^Fds, Gg, Gg, Gll^Fp, Gll^Fp, Gs^Fms, Gs^Fms, Gs^Fms, Gg, Ww, Gs^Fms, Ww, Ds, Ww, Ds, Ww, Ww, Ww, Ww, Ww, Ww, Ww, Ww
Gg, Gg, Gg, Gg, Gs^Fds, Hh^Fds, Gs^Fms, Hh^Fp, Hh^Fms, Hh^Fp, Gll^Fp, Gll^Fp, Gg, Gs^Fds, Gg, Gs^Fds, Gg, Gg^Fet, Ss, Ss, Ss, Gs^Fds, Gs^Fms, Gs^Fms, Gs^Fms, Gll^Fp, Gs^Fms, Gs^Fms, Ww, Ww, Ww, Ww, Gs^Fds, Ww, Gs^Fds, Ww, Gs^Fds, Ww, Gs^Fms, Ww, Gs^Fms, Wwf, Gs^Fms, Wwf, Gg, Gg
Ww, Gg, Gg, Gg, Gs^Fds, Gs^Fms, Gll^Fp, Gll^Fp, Ds, Ds, Ds, Ds, Ww, Gg, Ww, Ww, Ww, Ss, Ss, Ss, Ss, Gs^Fms, Gs^Fms, Gs^Fms, Wwf, Wwf, Ww, Ww, Ds, Ds, Gs^Fds, Gs^Fds, Gs^Fds, Gs^Fds, Gs^Fds, Gs^Fds, Gg, Gg, Gs^Fms, Gs^Fms, Gs^Fms, Gs^Fms, Gs^Fms, Gs^Fms, Hh, Hh
Ww, Ww, Ww, Ww, Ww, Gll^Fp, Ww, Gll^Fp, Ww, Ww, Ww, Ww, Gg, Ww, Gg, Ww, Ww, Ww, Ww, Ww, Ww, Gs^Fds, Ww, Gs^Fms, Ww, Ww, Ww, Gs^Fms, Gs^Fms, Gs^Fms, Gs^Fms, Gs^Fds, Gs^Fms, Gs^Fds, Gs^Fms, Gg, Gg, Gg, Gs^Fms, Gs^Fms, Gll^Tf, Gs^Fms, Gs^Fms, Gs^Fms, Gs^Fms, Hh
Ww, Ww, Gs^Fds, Ww, Ww, Ww, Gll^Fp, Ww, Gll^Fp, Gg, Hh, Hh, Hh, Gg, Hh, Ds, Ds, Ds, Gs^Fds, Gs^Fds, Gs^Fds, Ww, Gs^Fds, Ww, Gs^Fms, Ww, Gs^Fds, Ss, Ss, Ss, Gs^Fms, Gs^Fds, Gs^Fms, Gs^Fms, Gs^Fms, Gs^Fms, Gs^Fms, Gs^Fms, Gs^Fms, Gll^Tf, Gs^Fms, Gg^Ve, Gs^Fms, Gg, Gs^Fms, Gg
Gg, Gg, Gs^Fds, Gs^Fds, Gs^Fds, Gs^Fds, Gll^Fp, Gll^Fp, Hh^Fp, Hh, Hh^Fms, Hh, Hh, Hh, Hh, Hh, Hh, Gs^Fds, Gs^Fds, Gs^Fds, Gll^Tf, Gs^Fds, Gs^Fds, Gs^Fds, Ww, Ww, Gs^Fds, Ss, Ss, Ss, Gs^Fms, Gg, Gg, Gs^Fms, Gs^Fms, Gs^Fms, Gs^Fms, Gs^Fms, Gs^Fms, Gs^Fms, Gs^Fms, Gs^Fms, Gs^Fms, Gs^Fms, Gs^Fms, Gg
Gg, Gg, Gs^Fds, Gs^Fds, Gs^Fds, Hh^Fp, Hh^Fms, Hh^Fp, Hh^Fp, Hh^Fp, Hh^Fp, Hh^Fp, Hh^Fp, Hh^Fp, Hh^Fms, Hh^Fms, Gs^Fms, Gs^Fms, Gs^Fms, Gs^Fds, Gs^Fds, Gs^Ve, Ds, Ds, Ww, Gs^Fds, Gg, Ss, Gs^Fms, Gs^Fms, Gs^Fms, Gs^Fms, Gg, Gs^Fms, Gs^Fms, Gs^Fet, Gs^Fms, Gs^Fms, Gs^Fms, Gs^Fms, Gs^Fms, Gs^Fms, Cv, Gs^Fms, Gs^Fms, Gg
Gg, Gg, Gs^Fms, Gs^Fds, Gs^Ve, Hh^Fp, Gll^Fp, Gs^Fms, Gs^Fms, Hh^Fms, Gs^Fms, Hh^Fms, Gs^Fms, Hh^Fp, Gs^Fms, Gs^Fms, Gs^Fms, Gs^Fms, Gs^Fet, Gs^Fds, Gll^Tf, Gs^Fds, Gs^Fms, Ww, Ww, Gg, Gs^Fds, Gs^Fds, Gs^Fds, Gs^Fms, Gs^Fms, Gs^Fms, Gs^Fms, Gs^Fms, Gs^Fms, Gs^Fms, Gs^Fms, Gs^Fms, Gs^Fms, Gs^Fms, Gs^Fms, Cv, 3 Kv, Gs^Fms, Gs^Fms, Gg
Gg, Gs^Fms, Gs^Fms, Gs^Fds, Gs^Fds, Gs^Fds, Gll^Fp, Gs^Fms, Gs^Fds, Gs^Fms, Gs^Fms, Gs^Fms, Hh^Fms, Hh^Fms, Hh^Fms, Gs^Fms, Ss, Ss, Ss, Gs^Fds, Gs^Fds, Gs^Fds, Ww, Ww, Ds, Gs^Fms, Gs^Fds, Gg^Ve, Gs^Fms, Gs^Fms, Gs^Fms, Gs^Fms, Gs^Fds, Gs^Fms, Gll^Tf, Gs^Fms, Gs^Fms, Gs^Fms, Gs^Fms, Gs^Fms, Gs^Fms, Cv, Cv, Cv, Gs^Fms, Gg
Gs^Fms, Gs^Fms, Gs^Fms, Gs^Fds, Gs^Fds, Gs^Fds, Gg, Gll^Fp, Gll^Fp, Gs^Fds, Hh^Fds, Hh^Fds, Hh^Fds, Hh^Ve, Hh^Fms, Hh^Fms, Hh^Fms, Ss, Ss, Ss, Ss, Gs^Fds, Ww, Ww, Ds, Gs^Fms, Gs^Fms, Gs^Fms, Gs^Fms, Gs^Fms, Hh^Fms, Gs^Fms, Hh^Fms, Hh^Fms, Gs^Fms, Gg^Ve, Gs^Fms, Gs^Fms, Gs^Fms, Gs^Fms, Hh^Fms, Gs^Fms, Gg, Gg, Gs^Fms, Gg
Gs^Fms, Gs^Fms, Gs^Fms, Gs^Fms, Gg, Gll^Fp, Gll^Fp, Gg, Gs^Fms, Gll^Fp, Hh^Fp, Hh^Fds, Hh^Fds, Hh^Fds, Hh^Fds, Hh^Fms, Gs^Fms, Gs^Fms, Gs^Fms, Gs^Fds, Ww, Ww, Ds, Ds, Gs^Fms, Gs^Fms, Gs^Fms, Gs^Fms, Gs^Fms, Hh^Fms, Hh^Fms, Hh^Fms, Hh^Fms, Hh^Fms, Hh, Gg, Gg, Gs^Fms, Gs^Fms, Hh^Fms, Hh, Hh, Gs^Fds, Gs^Fds, Gs^Fds, Gg
Gs^Fms, Gs^Fms, Gs^Fms, Gg, Gg^Fet, Gg, Gg, Gll^Fp, Gs^Fms, Gs^Fms, Gll^Fp, Hh^Fp, Hh^Fp, Hh^Fds, Hh^Fds, Hh^Fds, Gs^Fds, Gs^Fms, Wwf, Gs^Fms, Ww, Ww, Gs^Fms, Gs^Fms, Gs^Fms, Gs^Fms, Gll^Fp, Gs^Fms, Gs^Fds, Hh^Fms, Hh^Fms, Hh^Fms, Hh^Fms, Hh^Fms, Gs^Fms, Gs^Fms, Gs^Fms, Gs^Fms, Gs^Fms, Gs^Fms, Gg, Gs^Fds, Gs^Fds, Gs^Fds, Gs^Fds, Gg
Gs^Fms, Gs^Fms, Gs^Fms, Gs^Fms, Gs^Fms, Gg, Gs^Fms, Gll^Fp, Gll^Fp, Gll^Fp, Gll^Fp, Gs^Fms, Gg, Hh^Fds, Gs^Fds, Hh^Fds, Gs^Fds, Gs^Fds, Gs^Fds, Ww, Ww, Gs^Fms, Gs^Fms, Gs^Fms, Gs^Fms, Gs^Fet, Gll^Fp, Gll^Fp, Hh^Fp, Hh^Fms, Hh^Fp, Hh^Fms, Hh^Fms, Hh^Fms, Gs^Fms, Gs^Fms, Gs^Fms, Gs^Fms, Gs^Fms, Gs^Fms, Gs^Fms, Gg^Ve, Gs^Fds, Gs^Fds, Gs^Fds, Gg
Gs^Fms, Gs^Fms, Gg^Ve, Gs^Fms, Gs^Fms, Gs^Fms, Hh^Fms, Hh^Fms, Hh^Fms, Gll^Fp, Gll^Fp, Gs^Fds, Gs^Fds, Gg, Gs^Fms, Gs^Fms, Gs^Fms, Gs^Fds, Gs^Fds, Gs^Fds, Gs^Fds, Ww, Wwf, Gs^Fms, Gs^Fms, Gs^Fms, Gs^Fms, Gll^Tf, Gs^Fms, Gll^Fp, Gs^Fms, Gll^Fp, Gll^Fp, Gll^Fp, Gll^Fp, Gs^Fms, Gs^Fms, Gs^Fms, Gs^Fms, Gs^Fms, Gs^Fms, Gs^Fds, Gs^Fds, Gs^Fds, Gg, Gg
Gg, Gs^Fms, Gs^Fms, Gs^Fms, Hh^Fms, Hh^Fms, Hh^Fms, Hh^Fms, Hh^Fms, Hh^Fms, Gs^Fms, Gll^Fp, Gll^Fp, Gs^Fds, Gs^Fms, Gs^Fms, Gll^Tf, Gll^Tf, Gs^Fms, Gs^Fds, Gg, Ww, Gs^Fms, Gs^Fms, Gg^Ve, Gs^Fms, Gll^Tf, Gs^Fms, Gs^Fms, Gs^Fms, Gs^Fds, Gll^Fp, Gll^Fp, Gll^Fp, Gll^Fp, Gg, Gg, Gs^Fms, Gs^Fms, Gs^Fms, Gll^Tf, Gs^Fds, Gs^Fds, Gs^Fds, Gg, Gg
Gg, Gg, Gg, Gg, Hh^Fds, Hh^Fms, Hh^Fms, Hh^Fms, Hh^Fms, Hh^Fms, Gs^Fms, Gs^Fds, Gg^Ve, Gll^Fp, Gs^Fds, Gll^Tf, Gll^Tf, Gs^Fms, Gs^Fms, Gs^Fds, Ds, Ww, Gs^Fms, Gs^Fms, Gs^Fms, Gs^Fms, Hh^Fms, Hh^Fms, Hh, Gg, Gll^Fp, Gll^Fp, Gll^Fp, Gll^Fp, Gs^Fms, Gg, Gg, Gg^Fet, Gg, Gs^Fms, Gs^Fds, Gs^Fds, Gs^Fds, Gs^Fds, Gs^Fms, Gg
Gg, Gg, Hh, Hh^Fds, Hh^Fds, Hh^Fds, Gs^Fds, Gs^Fds, Gs^Fms, Gs^Fms, Gg^Fms, Gg^Fms, Gg^Fms, Gs^Fds, Gg, Gs^Fds, Gs^Fms, Gll^Tf, Gs^Fms, Gs^Fms, Ds, Ww, Gs^Fms, Gs^Fms, Gs^Fms, Hh^Fms, Hh^Fms, Hh^Fms, Hh^Fds, Hh^Fds, Gll^Fp, Gs^Fds, Gs^Fds, Gs^Fms, Gs^Fms, Gs^Fms, Gg^Ve, Gg, Gs^Fms, Gg, Gs^Fds, Gs^Fds, Gs^Fds, Gs^Fds, Gs^Fms, Gs^Fms
Gg, Gg, Gs^Fds, Hh^Fds, Gs^Fds, Gs^Fds, Gs^Fds, Gs^Fds, Gs^Fds, Gg^Fms, Gg^Fms, Gg^Fms, Gg, Gg^Fms, Gg^Fms, Gg, Gg, Gs^Fms, Gs^Fms, Gs^Fms, Ww, Ww, Gs^Fms, Gs^Fms, Gs^Fms, Hh^Fms, Hh^Fds, Hh^Fds, Hh^Fds, Hh^Fds, Hh^Fp, Gs^Fds, Gs^Fds, Gs^Fet, Gs^Fms, Gs^Fms, Gs^Fms, Gs^Fms, Gs^Fms, Gs^Fds, Gs^Fds, Gs^Fds, Gs^Fds, Gs^Fms, Gs^Fms, Gs^Fms
Gg, Gg, Gs^Fds, Gs^Fds, Gs^Fds, Gs^Fds, Gs^Fds, Gs^Fds, Gg^Fms, Gg^Fms, Gg, Cv, Cv, Gg, Gll^Fms, Gg, Gs^Fms, Gg, Ww, Ww, Ww, Ww, Gs^Fms, Gg, Gs^Fms, Hh^Fds, Hh^Fds, Hh^Fds, Hh^Fds, Hh^Fp, Gs^Fds, Gs^Fms, Ss, Ss, Ss, Gll^Tf, Ss, Gs^Fms, Gs^Fds, Gs^Fds, Gs^Fds, Gs^Fds, Gg, Gg, Gg, Gs^Fms
Gg, Gs^Fds, Gs^Fds, Gs^Fds, Gs^Fds, Gg, Gg^Fms, Gg^Fms, Gg^Fms, Gg, 4 Kv, Cv, Gg, Gg, Gg^Fms, Gs^Fms, Ww, Ww, Ds, Ds, Ds, Ww, Gs^Fms, Gg, Gs^Fms, Gs^Fds, Gs^Fms, Hh^Fds, Gll^Fp, Gll^Fp, Ss, Ss, Ss, Ss, Ss, Ss, Ss, Ss, Gll^Tf, Gs^Fds, Gs^Fds, Gs^Fds, Gs^Fms, Gg, Gg, Gg
Gg, Gs^Fds, Gs^Fds, Gg^Ve, Gs^Fds, Gs^Fds, Gs^Fms, Gg^Fms, Cv, Cv, Gs^Fms, Cv, Gg^Fms, Gg^Fms, Gg, Gs^Fms, Ww, Ww, Gs^Fms, Gg^Ve, Ww, Ww, Gs^Fms, Gs^Fms, Gs^Fms, Gs^Fms, Gs^Fms, Gs^Fms, Gll^Fp, Gll^Fp, Gs^Fds, Ss, Gs^Fds, Ss, Ss, Gs^Fds, Gs^Fds, Ss, Gs^Fds, Gs^Fds, Gs^Fms, Gs^Fms, Gg^Ve, Gs^Fms, Gs^Fms, Gs^Fms
Gg, Gs^Fds, Gs^Fds, Gs^Fds, Gs^Fds, Gs^Fds, Gs^Fms, Gg^Fms, Gg^Fms, Gs^Fms, Gs^Fms, Gs^Fms, Gs^Fms, Gs^Fms, Gs^Fms, Ww, Ww, Gs^Fms, Gs^Fms, Gs^Fms, Ww, Gs^Fms, Gs^Fms, Gs^Fms, Gs^Fms, Gs^Fms, Gs^Fms, Gs^Fms, Gg, Gll^Fp, Gs^Fds, Gs^Fds, Gs^Fds, Gs^Fds, Gs^Fds, Gs^Fds, Gs^Fds, Gs^Fds, Gg, Gll^Tf, Gg, Gs^Fms, Gs^Fms, Gs^Fms, Gs^Fms, Gs^Fms
Gg, Gg, Gg, Gs^Fds, Gs^Fds, Gs^Fds, Gs^Fds, Gg^Fms, Gg, Gg^Fms, Gg, Gg^Fms, Gg, Gg, Gg, Ww, Gg, Gs^Fms, Gg, Gs^Fms, Ww, Ww, Gg, Gs^Fms, Gg, Gs^Fms, Gg, Gg, Gg, Gg, Gg, Gg, Gg, Gs^Fds, Gg, Gs^Fds, Gg, Gg, Gg, Gg, Gg, Gg, Gg, Gs^Fms, Gs^Fms, Gs^Fms
