Xu, Xu, Xu, Xu, Xu, Xu, Xu, Xu, Xu, Xu, Xu, Xu, Xu, Xu, Xu, Xu, Xu, Xu, Xu, Qxu, Qxu, Qxu, Xu, Xu, Xu, Xu, Xu, Xu, Xu, Xu, Xu, Xu, Xu, Xu, Xu, Xu, Xu, Uu
Wog, Xu, Xu, Xu, Wo, Xu, Xu, Xu, Wo, Xu, Wog, Xu, Wog, Xu, Wog^Vm, Xu, Uh, Xu, Qxu, Qxu, Qxu, Qxu, Qxu, Xu, Xu, Xu, Xu, Xu, Xu, Xu, Xu, Xu, Xu, Xu, Uh, Xu, Ur, Ur
Wog, Wog, Wog, Wo, Wo, Wo, Wo, Wo, Wwrg, Wog, Wog, Wog, 5 Kme, Wog, Wog, Wwg, Xu, Qxu, Qxu, Qxu, Qxu, Qxu, Xu, Qxu, Qxu, Qxu, Qxu, Xu, Urb, Urb^Ebn, Urb, Urb, Urb, Uu^Vu, Ur, Ur, Xu, Xu
Wog, Wog, Wo, Wo, Wwrg, Wog, Wwrg, Wog, Wog, Wog, Wog, Cme, Wog, Wog, Xu, Xu, Qxu, Xu, Xu, Xu, Xu, Xu, Xu, Xu, Xu, Qxu, Xu, Uu^Vu, Urb, Urb, Cud, Urb, Cud, Urb, Xu, Xu, Xu, Xu
Wog, Wog, Wo, Wo, Wog, Wwrg, Wog, Wog, Wog, Wog, Wog, Wog, Wog, Xu, Xu, Xu, Qxu, Qxu, Qxu, Xu, Xu, Xu, Xu, Xu, Uh, Xu, Xu, Xu, Urb, Urb, Cud, 3 Kud, Urb, Urb, Urb, Xu, Xu, Xu
Xu, Xu, Xu, Wog, Wog, Wog, Wog, Wwrg, Wog, Wog, Wwrg, Wog, Wog, Wog, Xu, Xu, Qxu, Qxu, Qxu, Uu^Vu, Uh, Xu, Xu, Qxu, Qxu, Uh, Uu, Uu, Urb, Urb, Urb, Cud, Urb, Urb, Urb, Xu, Xu, Xu
Xu, Xu, Uu^Tf, Wog, Wog, Wwrg, Wog, Wog, Wwrg, Wog, Wog, Wog, Wog, Wog, Xu, Xu, Xu, Qxu, Uh, Ur, Ur, Uh, Xu, Qxu, Uu, Qxu, Qxu^Bs/, Ur, Ur, Urb, Urb, Urb, Urb^Ebn, Urb, Uu^Vu, Xu, Xu, Xu
Xu, Xu, Wwg, Wwg, Wwrg, Wog, Wog, Wog, Wog, Wog, Wog, Wwrg, Wog, Wog, Xu, Xu, Qxu, Uu^Tf, Uh, Uu^Tf, Uu, Ur, Ur, Uh, Uu^Tf, Ur, Ur, Qxu^Bs/, Qxu, Uu^Vu, Uu^Tf, Xu, Xu, Xu, Qxu, Qxu, Xu, Xu
Xu, Xu, Wwrg, Wwg, Wwg, Wwg, Wwg, Wog, Wwrg, Wog, Wog, Wog, Wog, Wog, Xu, Qxu, Qxu, Uu, Uu, Uu, Ur, Ur, Uu^Tf, Ur, Ur, Ur, Uu^Tf, Uu, Qxu, Xu, Uu^Tf, Uu^Tf, Uh, Xu, Qxu, Qxu, Xu, Xu
Xu, Wwg, Wwg, Wwg, Xu, Wwg, Wwg, Wwrg, Wwg, Wog, Wog, Wog, Xu, Wwg, Wwg, Xu, Uh, Qxu, Ur, Ur, Uu^Vu, Uu^Tf, Uh, Uh, Ur, Ur, Ur, Uu, Qxu, Xu, Uu^Tf, Uu^Tf, Xu, Xu, Xu, Qxu, Xu, Xu
Xu, Wwg, Wwg, Xu, Uu^Tf, Wwg, Wwg, Wwg, Xu, Xu, Xu, Xu, Xu, Xu, Xu, Wwg, Wwg, Ur, Uu, Uu, Qxu, Qxu, Qxu, Ur, Uu^Tf, Uh, Uh, Ur, Uu^Tf, Xu, Wog, Wog, Wog, Xu, Qxu, Qxu, Qxu, Qxu
Xu, Wwrg, Wwg, Xu, Uu, Wwg, Wwg, Uu^Tf, Qxu, Qxu, Qxu, Xu, Qxu, Qxu, Qxu, Xu, Uu^Tf, Wwf, Wwg, Uu, Tb^Tf, Qxu, Ur, Ur, Ur, Uh, Uu^Tf, Ur, Xu, Xu, Wog, Wog, Wog, Xu, Qxu, Qxu, Qxu, Qxu
Xu, Wwg, Ur, Uh, Ur, Ur, Wwg, Uu, Uh, Qxu, Qxu, Qxu, Qxu, Qxu, Qxu, Uu^Tf, Uu, Ur, Uu, Wwg, Uu^Tf, Uu, Ur, Tb^Tf, Uh, Ur, Ur^Vu, Ur, Xu, Uh, Wog, Wog, Wog, Xu, Xu, Qxu, Xu, Xu
Xu, Uu, Uu, Ur, Uu, Uh, Xu, Wwg, Wwg, Xu, Xu, Qxu, Xu, Xu, Uu^Tfi, Uh, Ur, Ur^Vu, Ur, Wwg, Wwf, Wwf, Wwg, Uu, Uu^Tf, Uu, Ur, Uu, Wwg, Wwg, Xu, Wog, Xu, Xu, Qxu, Qxu, Xu, Xu
Xu, Xu, Uu, Ur, Uu^Vu, Xu, Xu, Xu, Wwg, Xu, Xu, Xu, Uh, Uh, Ur, Ur, Uu, Uu, Uu^Ii, Ur, Uh, Uu^Tf, Xu, Wwg, Wwg, Wwg, Wwf, Wwf, Uh, Uh, Uu^Tf, Xu, Xu, Xu, Qxu, Xu, Xu, Xu
Xu, Xu, Ur, Ur, Uu^Tf, Xu, Xu, Xu, Xu, Wwg, Wwf, Xu, Uu, Uu, Ur, Uu, Xu, Uu^Tf, Uu, Uu, Uu, Xu, Wwg, Wwg, Xu, Uu^Tf, Ur, Wwg, Xu, Uh, Uh, Uh, Uu^Tf, Xu, Xu, Uh, Uh^Vu, Xu
Xu, Xu, Ur, Uu, Uu^Tf, Xu, Xu, Xu, Uu, Ur, Xu, Wwf, Wwf, Ur, Uh, Xu, Uh, Xu, Uh, Ur, Ur, Wwf, Ur, Xu, Uh, Uu, Ur, Xu, Xu, Xu, Xu, Uh, Uh, Xu, Uh, Uh, Uh, Xu
Xu, Uh, Ur, Uu, Xu, Xu, Uu, Uu, Xu, Xu, Uu^Tf, Ur^Ii, Ur^Ii, Wwg, Wwg, Xu, Uh, Uh, Xu, Uu, Wwf, Wwf, Uu, Ur, Ur, Uh^Ii, Ur, Uh, Xu, Xu, Xu, Xu, Xu, Uh, Cte, 4 Kte, Uh, Xu
Xu, Uh, Uh, Ur, Ur, Ur, Xu, Xu, Xu, Xu, Uh, Uh, Ur, Uh, Xu, Wwg, Wwg, Wwg, Wwg, Uu^Tfi, Wwf, Uu^Tf, Xu, Uu^Vu, Ur, Uu, Ur, Xu, Uu^Vu, Xu, Uu^Tf, Xu, Uu^Tf, Uh, Uh, Uh, Uh, Xu
Uu, Xu, Uh, Ur, Uu^Tf, Xu, Qxu, Qxu, Uu^Vu, Xu, Uu, Uh, Ur, Ur, Ur, Wwg, Uu, Uu, Cte, Wwf, Uu^Tf, Wwg, Wwg, Xu, Uu, Ur, Uh^Ii, Ur, Uu, Uh, Uh, Xu, Uh, Uh, Uh, Uh, Xu, Xu
Uu, Uu, Uu, Ur, Uu^Tf, Xu, Qxu, Xu, Uu^Tf, Ur, Ur, Ur, Uh, Uu, Uu, Wwf, Ur, Kte, Cte, Ur, Uu, Xu, Xu, Wwg, Wwg, Ur, Uh^Ii, Ur, Uu^Tf, Uh, Uh, Uh, Uh, Uh, Uh, Uh, Xu, Xu
Xu, Uu, Uu^Tf, Ur, Uu, Xu, Qxu, Xu, Uu, Ur, Uh, Xu, Xu, Xu, Xu, Wwg, Uu, Ur, Uu^Vu, Ur, Uu, Uu^Tfi, Ur, Wwg, Ur, Wwf, Wwf, Wwf^Ii, Wwg, Uh, Xu, Uh, Xu, Uu^Tf, Uh, Uh, Uu^Tf, Xu
Xu, Xu, Uu^Tf, Ur, Uh, Xu, Qxu, Xu, Uh, Ur, Uu, Xu, Xu, Xu, Wwg, Wwg, Xu, Uu, Ur, Ur, Ur, Ur, Uu, Ur, Uu, Ur, Uh, Wwg, Xu, Wwg, Wwg, Xu, Xu, Uh, Uh, Uh, Xu, Xu
Xu, Xu, Uu, Ur, Uu, Xu, Qxu, Xu, Xu, Ur, Ur, Uh, Xu, Xu, Wwg, Xu, Uu, Uu^Ii, Ur, Uu^Tf, Uh, Uh, Xu, Xu, Uu^Tf, Ur, Uh, Xu, Xu, Xu, Xu, Wwg, Wwg, Uh, Uh, Uh, Xu, Xu
Xu, Xu, Uu^Vu, Ur, Ur, Xu, Xu, Uu^Ii, Xu, Uu^Tf, Uu, Ur, Wwg, Wwg, Xu, Wwg, Wwf, Ur, Uu, Uu^Tf, Xu, Xu, Uh^Vu, Ur, Ur, Ur, Ur, Uu, Xu, Xu, Xu, Xu, Wwf, Ur, Uu^Vu, Uh, Wwg, Wwg
Xu, Xu, Xu, Uh, Ur, Uu, Ur, Xu, Xu, Uh, Wwg, Wwf, Uu^Tf, Xu, Uu^Vu, Uu, Ur, Wwg, Wwg, Xu, Xu, Xu, Uh, Uu, Ur, Xu, Ur, Uu^Vu, Xu, Xu, Xu, Uh, Ur, Wwf, Wwf, Wwg, Xu, Wwg
Xu, Xu, Xu, Xu, Uh, Ur, Uu^Tf, Ur, Wwf, Wwg, Ur, Ur, Xu, Xu, Uu^Tf, Ur, Uu, Xu, Xu, Wwg, Wwg, Uu, Ur, Ur, Uu, Ur, Uh, Uu^Tf, Xu, Xu, Xu, Uu, Ur, Uu^Tf, Xu, Xu, Xu, Xu
Xu, Xu, Wwg, Xu, Xu, Uh, Wwg, Wwg, Uu, Ur, Uh, Xu, Xu, Uh, Ur, Ur, Uu^Tf, Uh, Uh, Xu, Ur, Wwf, Wwg, Xu, Uu^Tf, Ur, Uh, Uu, Xu, Xu, Uh, Uu, Ur, Xu, Xu, Xu, Xu, Xu
Wwg, Wwg, Xu, Wwg, Wwg, Wwg, Xu, Uu^Tf, Uu, Ur, Xu, Xu, Uh, Uu, Ur, Uu, Uu^Tf, Uu, Ur, Ur, Uu, Xu, Wwg, Xu, Xu, Ur, Uh, Uu, Xu, Xu, Uu^Tf, Ur, Uu^Tf, Uh, Xu, Xu, Xu, Xu
Xu, Xu, Xu, Xu, Xu, Xu, Uh, Uh, Ur, Ur, Xu, Xu, Uh, Ur, Uh, Ur, Ur, Ur, Xu, Ur, Ur, Xu, Wwg, Xu, Wwg, Ur, Ur, Ur, Xu, Uh, Uu, Ur, Uu, Uh, Uh, Xu, Xu, Xu
Xu, Xu, Xu, Xu, Xu, Xu, Xu, Uu^Vu, Ur, Uu^Tf, Uu, Uu, Ur, Ur, Ur, Uu, Uh^Vu, Uu, Xu, Uh, Ur, Uh, Uu, Wwg, Uu^Tf, Wwf, Wwg, Xu, Wwg, Xu, Xu, Ur, Ur, Uu^Vu, Uh, Xu, Xu, Xu
Xu, Xu, Xu, Xu, Uh, Uu^Tf, Uh, Uu, Ur, Uu^Tf, Ur, Ur, Uu, Uu, Xu, Xu, Xu, Xu, Uu^Tf, Ur, Uu, Ur, Ur, Wwg, Uu, Ur, Uu, Wwg, Xu, Wwg, Wwg, Uu, Ur, Uu, Uu^Tf, Xu, Xu, Xu
Xu, Xu, Xu, Xu, Uh, Uh, Uu, Uu, Ur, Ur, Ur, Uu^Tf, Uh, Xu, Uu, Uu^Tf, Ur, Uu, Ur, Ur, Xu, Xu, Wwg, Wwf, Ur, Ur, Uu^Tf, Uh, Uh, Xu, Ur, Wwg, Ur, Uu, Xu, Xu, Xu, Xu
Xu, Xu, Uu^Tf, Uh, Ce, Ur, Ur, Ur, Uu, Uu, Uu, Ur, Ur, Uu, Ur, Ur, Uh, Ur, Xu, Uu^Vu, Xu, Xu, Wwg, Xu, Ur, Uu^Tf, Uu^Tf, Uu, Uu, Uu, Ur, Wwf, Wwg, Uu^Tf, Xu, Xu, Wwg, Wwg
Xu, Xu, Uu, Ce, 1 Ke, Ce, Uu, Uu, Uu^Tf, Xu, Xu, Uh, Uu^Vu, Ur, Xu, Xu, Xu, Xu, Xu, Xu, Xu, Wwg, Xu, Xu, Uu^Tf, Ur, Ur, Uu^Tf, Ur, Ur, Uh, Uu, Xu, Wwg, Xu, Wwg, Xu, Xu
Hh, Uu, Ur, Ce, Ce, 2 Ce, Uu, Uh, Uu^Tf, Xu, Xu, Xu, Xu, Xu, Xu, Xu, Xu, Xu, Xu, Xu, Wwg, Wwg, Xu, Xu, Uh, Uh, Uu^Tf, Ur, Uu^Vu, Uu^Tf, Xu, Xu, Xu, Wwg, Wwg, Wwg, Xu, Xu
Hh, Hh, Hh, Ur, Uu, Uu, Uh, Uh, Xu, Xu, Xu, Xu, Xu, Xu, Xu, Xu, Wwg, Xu, Wwg, Xu, Wwg, Xu, Xu, Xu, Xu, Xu, Xu, Xu, Xu, Xu, Xu, Xu, Xu, Xu, Xu, Xu, Xu, Xu
Hh, Hh, Hh, Hh, Xu, Xu, Xu, Xu, Xu, Xu, Xu, Xu, Xu, Xu, Xu, Wwg, Wwg, Wwg, Wwg, Wwg, Xu, Xu, Xu, Xu, Xu, Xu, Xu, Xu, Xu, Xu, Xu, Xu, Xu, Xu, Xu, Xu, Xu, Xu
