Hh, Hh, Hh, Hh, Gs, Gs, Gs, Gs, Mm, Gs, Gs, Mm, Mm, Mm, Hh, Gs, Hh, Gs, Mm, Gs, Hh, Mm, Mm, Mm, Mm, Gs, Gs, Mm, Mm, Mm, Mm, Mm, Mm^Xm, Mm^Xm, Mm^Xm, Gs, Gs, Gs, Hh, Mm, Mm, Mm, Mm^Fp, Mm^Fp, Mm, Mm, Mm, Mm, Mm, Mm
Hh, Hh, Hh^Vc, Hh, Mm, Gs, Mm, Mm, Gs, Mm, Gs, Gs, Gs, Hh, Hh, Hh, Mm, Hh, Mm, Mm, Hh, Hh, Hh, Hh, Hh, Mm, Gs, Gs, Gs, Gs, Gs, Gs, Mm^Xm, Mm^Xm, Gs, Gs, Gs, Hh, Hh, Gs, Mm, Mm, Mm^Fp, Mm, Mm, Mm, Mm, Mm, Mm, Mm
Hh, Hh, Mm, Gs, Mm, Gs, Gs, Gs, Hh, Hh, Hh, Hh, Hh, Hh^Fp, Hh, Mm, Mm, Mm, Mm, Mm, Mm, Mm, Mm, Mm, Mm, Hh, Gs, Gs, Hh, Gs, Mm^Xm, Mm^Xm, Mm^Xm, Mm^Xm, Gs, Gs, Mm, Hh, Hh, Gs, Gs, Mm, Mm^Vc, Mm, Mm, Mm, 5 Ko, Mm, Mm, Mm
Hh, Hh, Mm, Mm^Fp, Cte, Cte, Cte, Gs, Gs^Fp, Hh, Hh^Fp, Hh, Hh, Hh, Mm, Mm, Mm^Xm, Mm, Mv, Qxu, Qxu, Qxu, Qxu, Qxu, Mm, Hh, Mm, Hh, Mm, Hh, Mm, Mm^Xm, Mm, Mm, Mm, Mm, Mm, Mm, Mm, Mm, Mm, Hh, Mm, Mm, Mm, Co, Co, Mm, Mm, Mm
Mm^Xm, Mm^Xm, Mm^Xm, Mm, Cte, 4 Kte, Cte, Gs, Gs^Fp, Hh, Hh, Hh^Vc, Hh, Hh, Mm^Xm, Mm^Xm, Mm^Xm, Md, Md, Md, Gs, Qxu, Hh, Mm, Mm, Mm^Fp, Mm, Mm, Gs, Gs, Gs, Mm^Vc, Mm, Mm, Gs, Mm^Fp, Mm, Mm, Gs^Fp, Mm, Mm, Mm, Mm, Mm, Mm, Mm, Mm, Mm^Fp, Mm^Xm, Mm^Xm
Mm, Mm^Xm, Mm^Fp, Mm, Hh, Cte, Mm^Fp, Gs, Gs, Hh, Hh^Fp, Hh, Mm, Mm, Mm^Xm, Mm^Xm, Mm, Mm, Mm, Mm, Hh, Mm, Mm, Mm, Mm, Mm, Mm, Mm, Gs, Gs, Mm, Mm, Mm, Mm, Gs, Gs, Hh^Fp, Gs^Fp, Mm, Mm, Mm, Mm, Mm, Mm^Fp, Mm, Mm, Mm, Mm, Mm^Xm, Mm^Xm
Mm, Mm, Mm, Gs, Qxu, Mm, Mm, Gs, Hh, Hh, Hh^Fp, Hh, Hh, Mm, Mm, Mm, Mm, Mm, Gs^Fp, Gs, Hh, Mm, Mm, Mm, Mm^Vc, Mm, Hh, Gs, Mm, Mm, Gs, Gs, Gs, Gs, Mm, Gs, Gs, Hh^Fp, Hh, Gs, Gs, Mm, Qxu, Qxu, Qxu, Mm, Mm, Hh, Mm, Mm^Xm
Mm, Mm, Gs, Qxu, Mm, Mm, Mm, Gs, Hh, Hh^Fp, Hh^Fp, Hh, Hh, Mm, Mm, Mm, Gs, Gs^Fp, Gs^Fp, Gs^Fp, Hh, Mm, Mm, Mm, Hh, Hh, Hh, Hh, Mm^Xm, Gs, Mm, Gs, Hh, Mm, Mm, Mm, Mm, Mm, Mm^Vc, Hh, Hh, Hh, Hh, Qxu, Qxu, Mm, Mm, Mm^Vc, Mm, Mm
Mm, Mm, Hh, Qxu, Gs, Mm, Gs^Vc, Gs, Hh, Hh, Hh, Hh, Gs, Mm, Mm, Mm, Gs, Gs^Vc, Gs^Fp, Gs^Fp, Gs, Hh, Mm, Mm, Qxu, Gs, Mm^Xm, Mm^Xm, Mm^Xm, Mm, Mm, Gs, Hh, Mm, Mm^Xm, Mm^Xm, Hh, Mm, Mm, Mm, Mm, Hh, Hh, Hh^Fp, Hh^Fp, Mm, Gs, Mm, Mm, Mm
Mm, Hh, Hh, Hh, Gs, Mm, Gs, Gs, Mm^Xm, Mm^Xm, Gs, Gs, Mm, Mm, Gs, Gs, Gs, Gs^Fp, Gs^Fp, Gs^Fp, Gs, Gs, Hh, Mm, Qxu, Qxu, Gs, Mm^Xm, Mm^Xm, Gs, Mm, Gs^Vc, Gs, Mm, Mm, Mm^Xm, Mm^Xm, Hh, Mm, Mm, Mm, Hh, Hh, Hh^Fp, Hh, Hh, Mm^Xm, Gs, Gs, Mm
Gs, Hh, Gs, Hh, Hh, Gs, Hh, Gs, Mm^Xm, Mm^Xm, Mm^Xm, Gs, Gs, Gs, Hh^Fp, Hh, Hh, Gs, Gs, Mm, Hh, Hh, Hh, Hh, Hh, Qxu, Gs, Gs, Mm, Mm, Mm, Mm, Mm, Mm, Gs, Mm, Hh, Mm, Hh, Mm, Mm, Mm, Mm, Hh, Hh, Mm^Xm, Mm^Xm, Mm^Xm, Gs, Mm
Gs, Gs^Fp, Gs^Fp, Gs^Fp, Gs, Hh, Gs, Gs, Mm^Xm, Mm^Xm, Gs, Gs, Mm, Mm^Fp, Hh^Fp, Hh^Fp, Hh, Gs, Mm, Mm, Hh, Hh, Hh^Fp, Hh^Fp, Gs, Gs, Mm, Mm, Mm, Mm, Gs, Gs, Qxu, Mm, Mm^Xm, Hh, Hh, Mm, Mm, Mm, Md, Mv, Md, Mm, Hh, Hh, Mm^Xm, Mm^Xm, Gs, Mm
Gs, Gs^Fp, Gs, Gs, Hh, Gs, Hh, Gs, Mm, Mm^Xm, Gs, Mm, Mm, Mm, Hh, Hh^Fp, Hh, Gs, Mm, Gs, Hh, Gs, Hh, Hh, Gs, Mm, Mm, Mm, Gs, Gs, Mm, Qxu, Qxu, Mm^Xm, Mm^Xm, Mm^Xm, Ww, Ww, Ww, Mm, Mm, Md, Mm, Mm, Gs, Hh, Hh, Hh, Mm, Mm
Hh, Hh, Hh, Hh, Hh, Hh, Hh, Gs, Mm, Mm, Mm, Mm, Mm, Mm, Mm, Hh, Hh, Hh, Mm, Hh, Gs, Hh, Hh, Hh, Mm, Mm, Gs, Gs, Mm, Mm, Mm, Qxu, Mm, Mm, Mm, Mm, Ww, Ww, Ww, Ww, Mm, Hh, Hh, Mm, Mm, Gs, Gs, Mm, Mm, Mm
Mm^Xm, Hh, Mm, Mm, Mm, Hh, Gs, Gs, Mm, Mm, Mm, Mm, Gs, Mm, Gs, Mm, Gs, Hh, Hh, Hh, Hh^Vc, Hh, Hh, Hh, Hh, Hh, Gs, Mm, Mm, Mm, Mm^Xm, Mm, Mm^Vc, Mm, Mm, Mm, Mm, Ww, Ww, Ww, Hh, Gs, Mm, Hh, Mm, Gs^Vc, Gs, Mm, Mm^Xm, Mm
Mm^Xm, Mm^Xm, Mm^Xm, Mm^Xm, Gs, Mm, Gs, Gs, Gs, Mm, Gs, Gs, Hh^Vc, Gs, Hh, Gs, Mm, Hh, Gs, Hh, Hh, Hh, Hh^Fp, Hh, Hh, Gs, Gs, Mm^Xm, Mm^Xm, Mm^Xm, Mm, Mm, Mm, Mm, Mm, Mm, Ww, Ww, Mm, Hh, Hh, Hh, Hh, Mm, Hh^Fp, Mm^Fp, Gs^Fp, Mm^Xm, Mm^Xm, Mm^Xm
Mm^Xm, Mm^Xm, Mm, Gs, Gs, Gs, Gs, Gs^Fp, Gs, Gs, Hh, Hh, Hh, Hh, Mm, Mm, Mm, Mm, Mm, Hh, Gs, Hh, Gs, Gs^Fp, Gs, Gs, Hh, Mm, Ce, Mm, Mv, Mm, Ce, Mm, Ww, Ww, Mm, Mm, Mm, Mm, Hh, Hh, Hh, Hh, Gs, Gs^Fp, Gs, Mm^Xm, Mm, Mm
Mm, Mm, Gs^Fp, Gs^Fp, Gs^Fp, Gs, Gs^Fp, Gs^Fp, Gs, Hh, Hh, Gs, Hh, Hh, Hh, Mm, Mm, Mm, Mm, Hh, Mm, Gs, Mm, Gs^Fp, Hh, Gs, Hh, Hh^Vc, Ce, Md, Md, Md, Ce, Mm, Hh, Ww, Gs, Gs, Gs^Fp, Mm, Gs^Fp, Gs, Hh, Gs, Gs, Mm, Mm, Gs, Gs, Mm
Gs, Gs, Gs^Fp, Gs^Fp, Gs^Fp, Gs^Fp, Gs^Fp, Gs, Hh, Hh, Mm^Xm, Mm^Xm, Mm^Xm, Hh, Hh, Hh, Mm, Mm, Mm, Mm, Mm, Mm, Gs, Hh, Gs, Gs, Hh, Hh, Mm, 1 Ke, Ce, 2 Ke, Mm, Mm, Mm, Ww, Ww, Gs, Gs, Gs^Fp, Gs, Hh, Gs, Mm, Hh, Gs, Gs, Mm, Gs, Gs
Gs, Gs, Gs, Gs^Fp, Gs, Gs^Fp, Gs^Fp, Gs, Qxu, Qxu, Qxu, Qxu, Mm^Xm, Mm^Xm, Gs, Hh, Hh, Mm, Mm, Mm^Fp, Mm^Xm, Mm^Xm, Hh, Hh, Gs, Hh, Mm, Mm, Mm, Mm, Mm, Mm, Mm, Mm, Mm, Mm, Ww, Hh, Ww, Gs, Ww, Gs, Gs, Mm, Mm, Gs, Gs, Mm, Mm^Xm, Mm
Gs, Gs, Gs, Gs, Hh, Gs, Gs, Hh, Hh, Qxu, Hh, Hh^Fp, Hh^Fp, Mm^Xm, Hh, Hh, Hh, Hh, Hh, Mm^Xm, Mm, Mm, Hh, Hh, Gs, Gs, Mm, Mm, Mm, Mm, Mm, Mm, Mm, Mm, Hh, Mm^Vc, Gs, Ww, Mm, Ww, Gs, Ww, Ww, Hh, Mm, Mm, Mm, Mm^Xm, Hh, Mm
Hh, Hh, Gs^Fp, Hh, Gs^Vc, Hh, Hh, Gs, Hh, Hh, Mm, Hh^Fp, Hh, Mm, Gs, Gs, Hh, Hh, Hh, Mm, Hh, Hh, Hh, Hh, Hh, Gs, Gs, Mm, Mm, Mm, Mm, Mm, Mm, Hh, Hh, Gs, Gs, Gs, Mm, Mm, Mm, Mm, Hh, Ww, Ww, Hh^Vc, Ww, Gs, Ww, Hh
Hh, Gs, Hh, Gs^Fp, Hh^Fp, Hh, Gs, Gs, Hh, Hh, Mm, Mm, Mm, Hh, Ww, Ww, Ww, Hh, Gs, Hh, Mm^Vc, Mm, Mm, Mm^Fp, Gs, Hh, Hh, Gs, Gs, Mm^Vc, Mm, Mm, Hh, Hh, Gs, Gs, Mm, Mm, Mm, Mm, Gs, Mm, Hh, Hh, Mm, Ww, Mm, Ww, Mm, Ww
Mm^Xm, Hh, Hh, Hh, Hh^Fp, Hh, Gs, Hh, Mm^Xm, Mm, Md, Mv, Md, Hh, Ww, Ww, Ww, Hh, Hh, Mm, Gs, Mm, Mm, Mm, Mm, Hh, Hh, Hh, Hh, Gs, Gs, Mm, Hh, Gs, Gs, Gs, Mm, Mm, Mm, Mm, Mm, Mm, Hh^Fp, Gs, Gs, Mm, Hh, Mm, Hhd, Md
Mm^Xm, Mm^Xm, Gs, Hh, Gs, Gs^Fp, Gs^Fp, Hh, Mm^Xm, Mm, Mm, Md, Hh, Hh, Ww, Ww, Ww, Hh, Mm, Mm^Xm, Mm, Mm, Mm, Mm, Mm^Fp, Hh, Hh, Hh, Hh, Hh, Hh^Fp, Gs, Gs, Gs, Mm, Gs, Gs, Mm, Md, Mm, Mm, Mm, Hh^Fp, Hh, Hh, Hh, Hhd, Hhd, Qlf, Qlf
Mm^Xm, Mm^Xm, Gs, Gs, Hh, Gs^Fp, Gs^Fp, Gs, Mm^Xm, Mm^Xm, Hh, Mm, Hh, Ww, Ww, Ww, Gs, Hh, Mm, Mm^Xm, Mm, Mm, Mm, Mm, Mm, Hh, Gs, Gs, Gs, Hh^Fp, Hh^Fp, Hh, Gs, Gs, Mm, Mm, Md, Md, Qlf, Hhd, Hh, Hh^Fp, Hh^Fp, Hh, Hh^Vc, Hh, Hhd, Qlf, Qlf, Qlf
Mm^Xm, Mm^Xm, Hh^Fp, Hh^Fp, Gs^Fp, Gs^Fp, Gs, Gs, Hh, Hh, Hh, Hh, Ww, Ww, Gs, Hh, Gs, Mm, Mm, Qxu, Qxu, Mm, Qxu, Mm, Hh, Hh, Gs, Mm, Gs, Mm, Rd, Hh, Hh, Gs, Mm, Mm, Md, Qlf, Qlf, Hhd, Mm, Hh, Mm, Hh, Hh, Hh, Hh, Hhd, Md, Qlf
Mm^Xm, Gs, Hh, Hh, Gs^Vc, Gs, Gs, Gs, Ww, Ww, Ww, Ww, Hh, Gs, Mm, Hh^Fp, Hh^Fp, Gs, Gs, Gs, Hh, Qxu, Hh, Hh, Hh, Hh, Hh, Mm, Mm, Md, Qlf, Rd, Gs, Hh, Gs^Fp, Mm, Mm, Md, Qlf, Md, Mm, Mm^Xm, Mm^Xm, Mm, Mm, Mm, Mm, Mm, Mm, Hhd
Gs, Gs^Fp, Gs, Gs, Ww, Ww, Ww, Ww, Mm^Xm, Ww, Hh, Hh, Hh, Mm, Mm, Hh^Fp, Cte, Hh, Gs, Gs, Mm, Hh, Mm, Hh, Mm, Gs, Hh, Gs, Mm, Md, Qlf, Md, Rd, Hh, Gs^Fp, Mm^Fp, Hh^Fp, Hhd, Qlf, Hhd, Hh, Mm, Mm^Xm, Mm, Ww, Ww, Ww, Mm, Mm, Mm
Gs, Gs^Fp, Gs^Fp, Gs, Ww, Gs, Gs, Mm, Mm, Mm, Hh, Hh, Hh, Mm, Mm^Vc, Cte, 3 Kte, Cte, Hh, Mm, Mm, Mm^Vc, Mm, Mm, Mm, Hh, Hh, Hh^Fp, Mm^Fp, Md, Md, Qlf, Qlf, Hhd, Hh, Hh^Fp, Hh, Hhd, Hhd, Hhd, Gs, Hh, Ww, Ww, Ww, Ww, Ww, Mm, Mm, Hh
Gs, Gs, Ww, Ww, Gs, Gs, Gs, Gs, Mm^Xm, Mm^Xm, Hh, Hh, Mm, Mm, Gs, Cte, Cte, Cte, Hh, Hh, Hh, Mm, Mm, Mm, Hh, Gs, Hh, Gs^Fp, Gs, Mm, Mm^Vc, Md, Md, Hhd, Hhd, Hhd, Hhd, Hh, Hh, Hh, Hh, Hh^Vc, Ww, Ww, Ww, Ww, Ww, Mm, Mm, Hh
Ww, Ww, Gs, Gs^Fp, Gs^Fp, Mm, Mm, Qxu, Mm^Xm, Gs, Mm, Mm, Mm, Mm, Gs, Hh, Hh, Hh, Mm, Mm^Xm, Mm, Hh, Hh, Hh, Mm, Hh, Gs, Gs, Md, Gs, Mm, Mm, Mm, Hh, Hhd, Qlf, Hhd, Mm, Md, Md, Md, Mm, Ww, Ww, Ww, Ww, Ww, Mm, Hh^Fp, Hh
Gs, Gs, Mm, Mm, Hh, Mm, Mm, Qxu, Hh, Gs, Mm^Fp, Mm, Mm, Mm, Hh, Gs, Gs, Mm, Mm^Xm, Mm^Xm, Mm, Hh, Hh, Mm, Mm^Xm, Mm^Xm, Mm, Md, Qlf, Md, Hh, Hh, Hh, Hh, Hh, Md, Mm, Hhd, Qlf, Qlf, Qlf, Wwt, Hh^Fp, Hh^Fp, Hh, Ww, Gs, Hh^Fp, Mm^Fp, Mm^Fp
Hh, Gs, Hh, Mm, Hh, Hh, Mm, Qxu, Hh, Hh, Mm, Mm^Fp, Mm^Fp, Mm, Hh, Hh, Mm, Mm^Xm, Mm, Mm, Hh, Hh, Mm, Mm^Xm, Mm^Xm, Mm^Xm, Mm^Xm, Rd, Rd, Rd, Hh, Hh^Fp, Hh^Fp, Mm, Mm, Hh, Hhd, Hhd, Hhd, Qlf, Wwt, Wwt, Gs^Fp, Gs, Mm, Gs, Mm, Mm, Mm, Gs^Fp
Hh, Hh, Gs^Vc, Mm, Gs, Mm, Mm, Qxu, Hh, Mm, Mm, Mm, Mm, Hh, Hh, Mm, Mm, Mm, Mm, Mm, Mm, Hh, Hh, Mm, Gs, Mm, Mm^Fp, Mm^Xm, Mm, Hh, Hh, Hh^Fp, Hh, Mm, Hhd, Hhd, Qlf, Hhd, Ww, Wwt, Md, Md, Md, Mm, Mm, Mm, Mm, Mm, Mm, Mm
Mm, Gs, Gs, Gs, Gs, Gs, Qxu, Qxu, Hh, Hh, Hh, Mm, Hh, Hh, Hh, Mm, Mm, Mm^Fp, Mm, Mm, Mm, Mm, Hh, Hh, Hh, Hh^Fp, Hh, Mm, Hh, Hh^Vc, Md, Hh, Hh, Hhd, Qlf, Qlf, Hhd, Wwt, Mm^Vc, Mm, Md, Qlf, Qlf, Md, Hhd, Mm, Mm, 6 Mm, Mm, Mm
Gs, Mm, Mm, Mm, Gs, Gs, Hh, Gs, Hh^Fp, Hh^Fp, Hh, Hh, Hh, Hh, Hh, Hh, Hh, Hh, Hh, Mm, Hh, Hh, Hh, Hh, Hh, Hh, Hh, Hh, Mm, Md, Qlf, Md, Gs, Md, Md, Qlf, Wwt, Ww, Mm, Hh, Hh, Hhd, Hhd, Qlf, Qlf, Hhd, Mm^Xm, Mm, Mm, Mm
Gs, Mm, Mm, Mm, Mm, Hh, Hh, Hh, Gs, Gs, Mm, Mm, Gs, Gs^Fp, Gs^Fp, Gs, Gs, Gs, Hh, Gs, Hh, Hh, Hh^Fp, Hh^Fp, Hh^Fp, Hh, Hh, Hh, Hh, Md, Qlf, Md, Hh, Gs, Ww, Wwt, Gs^Fp, Mm, Hh, Hh, Hhd, Hhd, Hhd, Hhd, Qlf, Rd, Gs^Fp, Mm, Gs, Mm
