Gs, Gs^Fp, Gs, Gs, Hh, Gs, Hh, Gs, Mm, Mm^Xm, Gs, Mm, Mm, Mm, Hh, Hh^Fp, Hh, Gs, Mm, Gs, Hh, Gs, Hh, Hh, Gs, Mm, Mm, Mm, Gs, Gs, Mm, Qxu, Qxu, Mm^Xm, Mm^Xm, Mm^Xm, Ww, Ww
Hh, Hh, Hh, Hh, Hh, Hh, Hh, Gs, Mm, Mm, Mm, Mm, Mm, Mm, Mm, Hh, Hh, Hh, Mm, Hh, Gs, Hh, Hh, Hh, Mm, Mm, Gs, Gs, Mm, Mm, Mm, Qxu, Mm, Mm, Mm, Mm, Ww, Ww
Mm^Xm, Hh, Mm, Mm, Mm, Hh, Gs, Gs, Mm, Mm, Mm, Mm, Gs, Mm, Gs, Mm, Gs, Hh, Hh, Hh, Hh^Vc, Hh, Hh, Hh, Hh, Hh, Gs, Mm, Mm, Mm, Mm^Xm, Mm, Mm^Vd, Mm, Mm, Mm, Mm, Ww
Mm^Xm, Mm^Xm, Mm^Xm, Mm^Xm, Gs, Mm, Gs, Gs, Gs, Mm, Gs, Gs, Hh^Vc, Gs, Hh, Gs, Mm, Hh, Gs, Hh, Hh, Hh, Hh^Fp, Hh, Hh, Gs, Gs, Mm^Xm, Mm^Xm, Mm^Xm, Mm, Mm, Mm, Mm, Mm, Mm, Ww, Ww
Mm^Xm, Mm^Xm, Mm, Gs, Gs, Gs, Gs, Gs^Fp, Gs, Gs, Hh, Hh, Hh, Hh, Mm, Mm, Mm, Mm, Mm, Hh, Gs, Hh, Gs, Gs^Fp, Gs, Gs, Hh, Mm, Ch, Mm, Mv, Mm, Ch, Mm, Ww, Ww, Mm, Mm
Mm, Mm, Gs^Fp, Gs^Fp, Gs^Fp, Gs, Gs^Fp, Gs^Fp, Gs, Hh, Hh, Gs, Hh, Hh, Hh, Mm, Mm, Mm, Mm, Hh, Mm, Gs, Mm, Gs^Fp, Hh, Gs, Hh, Hh^Vd, Ch, Md, Md, Md, Ch, Mm, Hh, Ww, Gs, Gs
Gs, Gs, Gs^Fp, Gs^Fp, Gs^Fp, Gs^Fp, Gs^Fp, Gs, Hh, Hh, Mm^Xm, Mm^Xm, Mm^Xm, Hh, Hh, Hh, Mm, Mm, Mm, Mm, Mm, Mm, Gs, Hh, Gs, Gs, Hh, Hh, Mm, 1 Kh, Ch, 2 Kh, Mm, Mm, Mm, Ww, Ww, Gs
Gs, Gs, Gs, Gs^Fp, Gs, Gs^Fp, Gs^Fp, Gs, Qxu, Qxu, Qxu, Qxu, Mm^Xm, Mm^Xm, Gs, Hh, Hh, Mm, Mm, Mm^Fp, Mm^Xm, Mm^Xm, Hh, Hh, Gs, Hh, Mm, Mm, Mm, Mm, Mm, Mm, Mm, Mm, Mm, Mm, Ww, Hh
Gs, Gs, Gs, Gs, Hh, Gs, Gs, Hh, Hh, Qxu, Hh, Hh^Fp, Hh^Fp, Mm^Xm, Hh, Hh, Hh, Hh, Hh, Mm^Xm, Mm, Mm, Hh, Hh, Gs, Gs, Mm, Mm, Mm, Mm, Mm, Mm, Mm, Mm, Hh, Mm^Vd, Gs, Ww
Hh, Hh, Gs^Fp, Hh, Gs^Vc, Hh, Hh, Gs, Hh, Hh, Mm, Hh^Fp, Hh, Mm, Gs, Gs, Hh, Hh, Hh, Mm, Hh, Hh, Hh, Hh, Hh, Gs, Gs, Mm, Mm, Mm, Mm, Mm, Mm, Hh, Hh, Gs, Gs, Gs
Hh, Gs, Hh, Gs^Fp, Hh^Fp, Hh, Gs, Gs, Hh, Hh, Mm, Mm, Mm, Hh, Ww, Ww, Ww, Hh, Gs, Hh, Mm^Vc, Mm, Mm, Mm^Fp, Gs, Hh, Hh, Gs, Gs, Mm^Vd, Mm, Mm, Hh, Hh, Gs, Gs, Mm, Mm
Mm^Xm, Hh, Hh, Hh, Hh^Fp, Hh, Gs, Hh, Mm^Xm, Mm, Md, Mv, Md, Hh, Ww, Ww, Ww, Hh, Hh, Mm, Gs, Mm, Mm, Mm, Mm, Hh, Hh, Hh, Hh, Gs, Gs, Mm, Hh, Gs, Gs, Gs, Mm, Mm
Mm^Xm, Mm^Xm, Gs, Hh, Gs, Gs^Fp, Gs^Fp, Hh, Mm^Xm, Mm, Mm, Md, Hh, Hh, Ww, Ww, Ww, Hh, Mm, Mm^Xm, Mm, Mm, Mm, Mm, Mm^Fp, Hh, Hh, Hh, Hh, Hh, Hh^Fp, Gs, Gs, Gs, Mm, Gs, Gs, Mm
Mm^Xm, Mm^Xm, Gs, Gs, Hh, Gs^Fp, Gs^Fp, Gs, Mm^Xm, Mm^Xm, Hh, Mm, Hh, Ww, Ww, Ww, Gs, Hh, Mm, Mm^Xm, Mm, Mm, Mm, Mm, Mm, Hh, Gs, Gs, Gs, Hh^Fp, Hh^Fp, Hh, Gs, Gs, Mm, Mm, Md, Md
Mm^Xm, Mm^Xm, Hh^Fp, Hh^Fp, Gs^Fp, Gs^Fp, Gs, Gs, Hh, Hh, Hh, Hh, Ww, Ww, Gs, Hh, Gs, Mm, Mm, Qxu, Qxu, Mm, Qxu, Mm, Hh, Hh, Gs, Mm, Gs, Mm, Rd, Hh, Hh, Gs, Mm, Mm, Md, Qlf
Mm^Xm, Gs, Hh, Hh, Gs^Vc, Gs, Gs, Gs, Ww, Ww, Ww, Ww, Hh, Gs, Mm, Hh^Fp, Hh^Fp, Gs, Gs, Gs, Hh, Qxu, Hh, Hh, Hh, Hh, Hh, Mm, Mm, Md, Qlf, Rd, Gs, Hh, Gs^Fp, Mm, Mm, Md
Gs, Gs^Fp, Gs, Gs, Ww, Ww, Ww, Ww, Mm^Xm, Ww, Hh, Hh, Hh, Mm, Mm, Hh^Fp, Hh, Hh, Gs, Gs, Mm, Hh, Mm, Hh, Mm, Gs, Hh, Gs, Mm, Md, Qlf, Md, Rd, Hh, Gs^Fp, Mm^Fp, Hh^Fp, Hhd
Gs, Gs^Fp, Gs^Fp, Gs, Ww, Gs, Gs, Mm, Mm, Mm, Hh, Hh, Hh, Mm, Mm^Vc, Hh, Hh, Hh, Hh, Mm, Mm, Mm^Vc, Mm, Mm, Mm, Hh, Hh, Hh^Fp, Mm^Fp, Md, Md, Qlf, Qlf, Hhd, Hh, Hh^Fp, Hh, Hhd
Gs, Gs, Ww, Ww, Gs, Gs, Gs, Gs, Mm^Xm, Mm^Xm, Hh, Hh, Mm, Mm, Gs, Hh, Hh, Hh, Hh, Hh, Hh, Mm, Mm, Mm, Hh, Gs, Hh, Gs^Fp, Gs, Mm, Mm^Vc, Md, Md, Hhd, Hhd, Hhd, Hhd, Hh
Ww, Ww, Gs, Gs^Fp, Gs^Fp, Mm, Mm, Qxu, Mm^Xm, Gs, Mm, Mm, Mm, Mm, Gs, Hh, Hh, Hh, Mm, Mm^Xm, Mm, Hh, Hh, Hh, Mm, Hh, Gs, Gs, Md, Gs, Mm, Mm, Mm, Hh, Hhd, Qlf, Hhd, Mm
Gs, Gs, Mm, Mm, Hh, Mm, Mm, Qxu, Hh, Gs, Mm^Fp, Mm, Mm, Mm, Hh, Gs, Gs, Mm, Mm^Xm, Mm^Xm, Mm, Hh, Hh, Mm, Mm^Xm, Mm^Xm, Mm, Md, Qlf, Md, Hh, Hh, Hh, Hh, Hh, Md, Mm, Hhd
Hh, Gs, Hh, Mm, Hh, Hh, Mm, Qxu, Hh, Hh, Mm, Mm^Fp, Mm^Fp, Mm, Hh, Hh, Mm, Mm^Xm, Mm, Mm, Hh, Hh, Mm, Mm^Xm, Mm^Xm, Mm^Xm, Mm^Xm, Rd, Rd, Rd, Hh, Hh^Fp, Hh^Fp, Mm, Mm, Hh, Hhd, Hhd
Hh, Hh, Gs^Vc, Mm, Gs, Mm, Mm, Qxu, Hh, Mm, Mm, Mm, Mm, Hh, Hh, Mm, Mm, Mm, Mm, Mm, Mm, Hh, Hh, Mm, Gs, Mm, Mm^Fp, Mm^Xm, Mm, Hh, Hh, Hh^Fp, Hh, Mm, Hhd, Hhd, Qlf, Hhd
Mm, Gs, Gs, Gs, Gs, Gs, Qxu, Qxu, Hh, Hh, Hh, Mm, Hh, Hh, Hh, Mm, Mm, Mm^Fp, Mm, Mm, Mm, Mm, Hh, Hh, Hh, Hh^Fp, Hh, Mm, Hh, Hh^Vc, Md, Hh, Hh, Hhd, Qlf, Qlf, Hhd, Wwt
Gs, Mm, Mm, Mm, Gs, Gs, Hh, Gs, Hh^Fp, Hh^Fp, Hh, Hh, Hh, Hh, Hh, Hh, Hh, Hh, Hh, Mm, Hh, Hh, Hh, Hh, Hh, Hh, Hh, Hh, Mm, Md, Qlf, Md, Gs, Md, Md, Qlf, Wwt, Ww
Gs, Mm, Mm, Mm, Mm, Hh, Hh, Hh, Gs, Gs, Mm, Mm, Gs, Gs^Fp, Gs^Fp, Gs, Gs, Gs, Hh, Gs, Hh, Hh, Hh^Fp, Hh^Fp, Hh^Fp, Hh, Hh, Hh, Hh, Md, Qlf, Md, Hh, Gs, Ww, Wwt, Gs^Fp, Mm
Mm, Mm, Mm, Mm, Gs^Fp, Gs^Fp, Gs, Gs^Vc, Gs, Gs, Mm, Mm, Mm, Gs^Fp, Hh, Hh, Hh, Hh, Gs^Vc, Hh, Gs, Gs^Fp, Gs, Gs, Gs^Fp, Hh^Fp, Gs, Hh, Gs, Hhd, Qlf, Hhd, Hh, Gs^Fp, Ww, Gs^Fp, Qlf, Hhd
Gs, Mm, Gs, Gs, Hh, Gs^Fp, Hh, Gs, Hh, Gs, Mm, Mm, Gs^Fp, Gs^Fp, Gs, Hh, Gs, Gs, Mm, Mm, Mm, Hh, Mm, Mm, Mm, Mm, Mm, Gs, Gs, Hhd, Qlf, Hhd, Md, Gs^Fp, Wwt, Md, Qlf, Qlf
Gs, Gs, Gs, Hh, Mv, Hh, Hh, Hh, Mm, Mm, Hh, Hh, Hh^Fp, Gs^Fp, Gs, Mm, Mm, Mm, Mm, Mm, Mm, Hh, Mm, Mm, Mm, Mm, Mm, Gs, Gs, Hhd, Hhd, Qlf, Md, Mm, Wwt, Qlf, Rd, Rd
Gs, Gs, Hh, Md, Md, Md, Mm, Hh, Hh, Mm, Hh, Hh^Fp, Hh, Hh, Hh, Gs, Gs, Mm, Mm, Mm, Gs, Hh, Mm^Fp, Mm, Mm, Mm, Mm, Mm, Gs, Hh, Hhd, Qlf, Qlf, Hhd, Ww, Md, Mm, Gs^Vc
Gs, Mm, Hh, Mm, Mm, Hh, Mm, Hh, Gs, Hh, Hh, Hh, Hh, Hh, Gs, Gs^Vc, Hh, Qxu, Gs, Hh, Hh, Gs, Gs^Fp, Gs, Gs, Gs^Vc, Hh, Gs, Hh^Fp, Hh^Fp, Hh, Hhd, Hhd, Hhd, Ww, Mm, Md, Rd
Gs, Mm, Hh, Hh, Hh, Mm, Mm, Mm, Mm^Vc, Gs, Gs, Gs, Gs, Mm, Mm^Xm, Mm, Qxu, Qxu, Gs^Fp, Gs, Gs, Gs^Fp, Hh^Fp, Hh, Hh, Hh, Hhd, Gs, Hhd, Hh^Fp, Hh, Hh, Ww, Ww, Mm, Mm, Rd, Qlf
Hh, Hh, Gs^Vc, Gs, Gs, Gs, Hh, Gs, Gs, Gs, Gs^Fp, Gs^Fp, Gs, Mm^Xm, Mm^Xm, Mm^Xm, Hh, Hh, Gs^Fp, Gs, Hh, Gs, Hh, Hh^Fp, Rd, Hhd, Qlf, Hhd, Qlf, Hhd, Ww, Ww, Mm, Mm, Mm^Xm, Mm^Xm, Hh, Hhd
Hh, Hh, Gs, Gs, Ce, Gs, Hh, Gs, Gs, Hh, Hh^Fp, Hh^Fp, Hh, Gs, Gs, Gs, Hh, Gs^Fp, Gs^Fp, Gs^Fp, Hh^Fp, Hh, Rd, Hhd, Qlf, Qlf, Qlf, Qlf, Wwt, Wwt, Md, Md, Md^Xm, Mm^Xm, Rd, Hhd, Rd, Gs^Fp
Gs, Gs, Gs, Ce, 3 Ke, Ce, Gs, Hh, Hh, Hh, Gs^Vc, Hh^Fp, Gs^Fp, Gs^Fp, Gs, Gs, Mm, Mm^Xm, Mm^Xm, Gs^Fp, Gs, Hhd, Rd, Qlf, Hhd, Hhd, Hhd, Hhd, Ww, Mm, Md, Qlf, Qlf, Rd, Qlf, Qlf, Qlf, Md
Hh, Hh, Gs, Ce, Ce, Ce, Gs, Hh, Hh, Hh, Hh, Hh^Fp, Hh^Fp, Gs^Fp, Mm, Mm, Md, Md^Xm, Md^Xm, Gs, Mm, Rd, Hhd, Hhd, Gs^Fp, Hh^Fp, Hh, Gs^Vc, Ww, Mm, Gs, Rd, Hhd, Qlf, Hhd, Hhd, Rd, Hhd
Hh, Hh, Hh, Gs, Qxu, Qxu, Qxu, Hh, Gs, Gs, Hh, Hh, Hh^Fp, Gs, Rd, Md, Qlf, Qlf, Qlf, Md, Md, Hh, Hh, Hh, Gs, Gs^Fp, Gs^Fp, Hh, Ww, Hh, Mm^Xm, Mm^Xm, Mm^Xm, Hhd, Gs, Gs^Fp, Gs^Fp, Hh^Fp
Hh, Hh, Gs, Qxu, Qxu, Qxu, Qxu, Hh, Gs, Gs, Hh, Hh, Gs, Gs^Fp, Rd, Qlf, Qlf, Qlf, Qlf, Qlf, Rd, Hh, Gs, Hh, Gs, Gs, Gs, Ww, Ww, Mm^Xm, Mm^Xm, Mm^Xm, Mm^Xm, Mm^Xm, Gs, Gs, Gs, Gs
